######
#@...#
#.##.#
#.##.#
#....#
######