#########
#..#....#
#..#.##.#
#..#.##.#
##......#
#......##
#.##.####
#.##.####
#@...####
#########