#########
#...#...#
#.#.#.#.#
#.#.#.#.#
#.......#
###.#.###
#.......#
#.#.#.#.#
#.#.#.#.#
#@..#...#
#########