#########
#.#.....#
#.......#
#.#####.#
#.###...#
#.##..###
#.##....#
#.#####.#
#@......#
#########