#########
#...#...#
#.#.#.#.#
#.#.#.#.#
#@......#
###.#.###
###.#.###
###.#.###
###...###
#########