#########
#.......#
#.#####.#
#.#...#.#
#.#.#.#.#
#.#...#.#
#.#.###.#
#.#.....#
#@#######
#########