#########
#.......#
#.#.#.#.#
#...#...#
###.#.###
###.#.###
#...#...#
#.#####.#
#@......#
#########