#########
#.......#
#..###.##
#.......#
##......#
#......##
#.......#
#..###..#
#@......#
#########