#########
#...#...#
#.#.#.#.#
#.......#
#.#####.#
#...#...#
#.#.#.#.#
#...#...#
###.#.###
#...#...#
#.#.#.#.#
#@......#
#########