#########
##.....##
#...#...#
#..###..#
#..###..#
#.#####.#
#..###..#
#...#...#
#@..#...#
##.....##
#########