#########
#.#...###
#.#.#.###
#.#.#.###
#.#.#...#
#.#.###.#
#....#..#
#.##.#.##
#....#..#
#.####..#
#@......#
#########