#######
#     #
# ### #
# # # #
# # # #
# # # #
#@#   #
#######