#########
##......#
##.##.###
#...#...#
#.....#.#
#.#.....#
#....##.#
#.###...#
##....###
##.#....#
##..###.#
###.#...#
#@....###
#########