#########
##......#
##.####.#
#.......#
#..####.#
#.##....#
#.##.##.#
#..#....#
#@.###..#
##.###..#
##.###..#
#########