#########
#..#....#
#..#.#.##
#......##
##......#
#.......#
#.#######
#.#.....#
#....##.#
#.#####.#
#@......#
#########