#########
#..###..#
#...#...#
#.#.#.#.#
#.#.#.#.#
#.#.#.#.#
#.#.#.#.#
#@......#
#########