#########
##......#
#.......#
#..##.#.#
#...#.#.#
#.....#.#
#.#.###.#
#@#.....#
#########