#########
##....###
#......##
#.......#
##.###.##
##......#
#.......#
#@......#
#########