#######
#   # #
# # # #
#     #
### # #
#@  # #
#######