#########
#...#...#
#.#.#.#.#
#.......#
###.#.###
#...#...#
#.#####.#
#@......#
#########