#########
#...##..#
###.....#
#......##
#.......#
#######.#
#@......#
#########