#########
#  ## ###
#     ###
##  #  ##
#   ## ##
# #     #
#@      #
#########