#########
##......#
#.......#
#..###..#
#..###..#
#.......#
#@.....##
#########