#########
##......#
##.####.#
##.#....#
##.#.##.#
##.#.##.#
#@.#....#
#########