#########
#...#...#
#.......#
#.###...#
#......##
######..#
#...##..#
#@#.....#
#########